./utest/input/monocyte_S00_mal_chrX_binary.txt	male
./utest/input/monocyte_S01_mal_chrX_binary.txt	male
./utest/input/monocyte_S02_mal_chrX_binary.txt	male
./utest/input/monocyte_S03_mal_chrX_binary.txt	male
./utest/input/monocyte_S04_mal_chrX_binary.txt	male
./utest/input/monocyte_S05_mal_chrX_binary.txt	male
./utest/input/monocyte_S06_mal_chrX_binary.txt	male
./utest/input/monocyte_S07_mal_chrX_binary.txt	male
./utest/input/monocyte_S08_mal_chrX_binary.txt	male
./utest/input/monocyte_S09_mal_chrX_binary.txt	male
./utest/input/monocyte_S10_fem_chrX_binary.txt	female
./utest/input/monocyte_S11_fem_chrX_binary.txt	female
./utest/input/monocyte_S12_fem_chrX_binary.txt	female
./utest/input/monocyte_S13_fem_chrX_binary.txt	female
./utest/input/monocyte_S14_fem_chrX_binary.txt	female
./utest/input/monocyte_S15_fem_chrX_binary.txt	female
./utest/input/monocyte_S16_fem_chrX_binary.txt	female
./utest/input/monocyte_S17_fem_chrX_binary.txt	female
./utest/input/monocyte_S18_fem_chrX_binary.txt	female
./utest/input/monocyte_S19_fem_chrX_binary.txt	female